黄金积存=黄金积存扣款
短信收费=银行短信费
短信服务费=银行短信费
服务费=银行短信费
信使费=银行短信费
短信扣费=银行短信费
短信费=银行短信费
收费&服务费=支付宝短信费
手机月=手机月费
增值服务使用费（自驾宝）=自驾宝服务扣费
增值服务使用费（还款宝）=还款宝服务扣费
增值服务使用费（安心宝）=安心宝服务扣费
增值服务使用费（旅行宝）=旅行宝服务扣费
电费=交电费
水费=交水费
歌华=歌华有线扣款
个人贷款还款=个人贷款还款
归还个贷=归还个贷
收回贷款本息=贷款本息
贷款还息=贷款还息
贷款还本=贷款还本
还本=贷款还本
还利=贷款还利
还贷=贷款还贷
壹基金每天1元钱项目=壹基金捐款
安健无忧=安健无忧保险
至尊保=至尊保保险
信福无忧=信福无忧保险
和谐人生=和谐人生保险
吉福安康=吉福安康保险
银联通转入=银联通定投
分期付款余额转移手续费=分期手续费
消费分期=消费分期
招商银行网上商城=招行商城消费分期
浙江银泰电子商务01-01=银泰网消费分期
苹果在线商店=苹果店消费分期
北京京东世纪网关=京东消费分期
北京京东世纪网关&分期手续费=京东消费分期手续费
支付宝&分期=支付宝消费分期
信用卡商城苹果店=苹果店消费分期
联合网络=联通分期
联通分期支付=联通分期
北京联通=联通分期
捷信扣款=捷信消费分期
信用卡分期=信用卡分期
宜信惠民=宜信惠民还款
淘宝小额信用等额本金=淘宝小额贷还款
亚马逊中国=亚马逊消费分期
易达金=易达金分期
账单分期&手续费=账单分期手续费
账单分期=现金分期手续费
现金分期&手续费=现金分期手续费
现金分期=现金分期
循环利息=循环利息
滞纳金=滞纳金
分期手续费=分期手续费
丰付扣款=丰付扣款
利息=利息到账
结息=结息到账
工资=发工资
回馈金=回馈金返回
社保=社保入账
交通补贴=发交通补贴
劳务费=发劳务费